14 14
C,6,1,file:greenDoor.jpg,false,green
D,6,2,false
T,6,3,true
Q,6,4,false
B,6,5,false
K,6,6,false,green
Z,6,7,false
T,6,8,true
MAP
WWWWWWWWWWWWWW
WFFFFFCFWFFFFW
WFFFFFDFSFFFFW
WFFFFFTFGFFFFW
WFFFFFQFHFFFFW
WFFFFFBFAFFFFW
WFFFFFKFFFFFFW
WFFFFFZFFFFFFW
WFFFFFTFFFFFFW
WFFFFFFFFFFFFW
WFFFFFFFFFFFFW
WFFFFFFFFFFFFW
WFFFFFFFFFFFFW
WWWWWWWWWWWWWW
link,6,3,6,8
link,6,8,6,3
player,8,6,0,false,false
straight,1,6,1
